Map:
------------
------------
---bbbbbb---
---b-##-b---
---b-##-b---
---bbbbbb---
------------
------------
---Y----Y---
000Y----Y000
000Y----Y000
000Y----Y000
000Y-##-Y000
000Y----Y000
111111111111
------------
------------
------------
------------
------------
------------
------------
------------
------------
------------
Map/

Meta:
Name: LEVEL 4
PowerUp: #
Unbreakable: Y
Hardened: 1
Meta/

Legend:
0) orange-block.png
